1111111111111
11E111P0C1111
1111111111111