111111111111111111111111111111111111111
100C100C100C100C100C100C100C100C100C101
10100C100C100C100C100C100C100C100C100C1
111111111111111111111111111111111111101
100C100C100C100C100C100C100C100C100C101
1C100C100C100C100C100C100C100C100C100C1
10000000000000Y000000000000000000000011
100C100C100C100C100C100C100C100C100C101
1C100C100C100C100C100C100C100C100C100C1
111111111111111111111111111111111111101
100C100C100C100C100C100C100C100C100C101
1C100C1Y0C100C100C100C100C10YC100C100C1
100000000000E00000Y00000000000000000011
100C100C100C100C000C100C100C100C100C101
1C100C100C100C000C000C100C100C100C100C1
11000000Y0000000Y00000000Y00000000Y0101
100C100C100CC00C000C000C100C100C000C101
1C100C10YC10PC100C100C100E000C100C100C1
111111111111111111111111111111111111111