11111111111111
111P11111100C1
11111E11111111
11111111111111